#1+++++++++#############################
+++##############++++++++++####+++++++++
+++####++++++++++++++++++++#####++++++++
+++###+++++++++++++++++++++####+++++++++
++++###+++++++++++++++++++++####++++++++
++++++++++++++++++++++++++++++++++++++++
++++#############++++++++++##########+++
++++++######+++++++++++++++++#######++++
+++++++#####++++++++++++++++++#####+++++
+++++++++##++++++++++++++++++++###++++++
+++++++++###########++++++++#######+++++
++++++++++++++++++++++++++++++++++++++++
+++++########+++++++++++++#######+++++++
+++++######+++++++++++++++########++++++
++++++####++++++++++++++++++######++++++
++++###############++++++++2+++#########